//MAP CONVERTED BY dmm2tgm.py THIS HEADER COMMENT PREVENTS RECONVERSION, DO NOT REMOVE
"ac" = (
/obj/effect/mapping_helpers/airlock/access/any/supply/general,
/obj/machinery/door/airlock/mining{
	name = "Cargo Hold"
	},
/obj/effect/mapping_helpers/airlock/access/any/security/general,
/obj/structure/cable,
/turf/open/floor/plating/reinforced,
/area/shuttle/escape/engine)
"ag" = (
/turf/closed/wall/mineral/titanium/nodiagonal,
/area/shuttle/escape)
"as" = (
/obj/effect/turf_decal/box/corners,
/obj/structure/closet/crate/large,
/obj/machinery/portable_atmospherics/canister/plasma,
/obj/item/lighter/skull,
/turf/open/floor/plating,
/area/shuttle/escape)
"at" = (
/obj/structure/closet/crate/cardboard/mothic,
/obj/item/storage/box/mothic_rations,
/obj/item/storage/box/mothic_rations,
/obj/item/food/cake/mothmallow,
/turf/open/floor/catwalk_floor/iron_smooth,
/area/shuttle/escape/engine)
"aE" = (
/obj/structure/closet/crate/large,
/obj/item/gun/energy/disabler/smoothbore,
/obj/item/gun/energy/disabler/smoothbore{
	pixel_y = 6
	},
/obj/item/gun/energy/disabler/smoothbore{
	pixel_y = -6
	},
/turf/open/floor/plating,
/area/shuttle/escape)
"aS" = (
/obj/effect/turf_decal/box/corners{
	dir = 8
	},
/obj/structure/closet/crate/silvercrate,
/turf/open/floor/plating,
/area/shuttle/escape)
"aT" = (
/obj/machinery/power/shuttle_engine/heater,
/obj/structure/window/reinforced/survival_pod/spawner/directional/north,
/turf/open/floor/plating,
/area/shuttle/escape/engine)
"dx" = (
/obj/machinery/computer/communications,
/obj/machinery/light/directional/east,
/turf/open/floor/mineral/titanium/white,
/area/shuttle/escape)
"ej" = (
/obj/effect/turf_decal/box/corners,
/turf/open/floor/plating,
/area/shuttle/escape)
"eN" = (
/obj/effect/decal/cleanable/blood,
/turf/open/floor/mineral/titanium,
/area/shuttle/escape)
"fj" = (
/obj/docking_port/mobile/emergency{
	name = "Haugan emergency spaceplane";
	port_direction = 4;
	dir = 8
	},
/turf/open/floor/mineral/titanium/white/airless,
/area/shuttle/escape)
"gj" = (
/obj/structure/chess/blackbishop,
/obj/structure/chess/blackbishop,
/obj/structure/chess/blackking,
/obj/structure/chess/blackknight,
/obj/structure/chess/blackknight,
/obj/structure/chess/blackqueen,
/obj/structure/chess/blackrook,
/obj/structure/chess/blackrook,
/obj/structure/chess/blackpawn,
/obj/structure/chess/blackpawn,
/obj/structure/chess/blackpawn,
/obj/structure/chess/blackpawn,
/obj/structure/chess/blackpawn,
/obj/structure/chess/blackpawn,
/obj/structure/chess/blackpawn,
/obj/structure/chess/blackpawn,
/obj/structure/closet/crate/large,
/obj/structure/cable,
/turf/open/floor/iron/dark/textured_half,
/area/shuttle/escape/engine)
"hc" = (
/obj/machinery/light/small/directional/east,
/obj/structure/closet/crate/large,
/obj/item/holosign_creator/atmos{
	desc = "How generous!";
	pixel_y = -8
	},
/obj/effect/turf_decal/box/corners{
	dir = 4
	},
/turf/open/floor/plating,
/area/shuttle/escape)
"hn" = (
/obj/structure/closet/mini_fridge,
/turf/open/floor/plating,
/area/shuttle/escape)
"hH" = (
/obj/item/pizzabox/bomb/armed,
/obj/item/pizzabox/random,
/obj/item/pizzabox/random,
/obj/item/pizzabox/random,
/obj/item/pizzabox/random,
/obj/structure/closet/crate/large,
/turf/open/floor/plating,
/area/shuttle/escape)
"iw" = (
/obj/machinery/light/directional/north,
/turf/open/floor/mineral/titanium/white,
/area/shuttle/escape)
"iy" = (
/obj/machinery/power/shuttle_engine/propulsion/right,
/turf/open/floor/plating,
/area/shuttle/escape/engine)
"kb" = (
/obj/structure/closet/crate/solarpanel_small,
/turf/open/floor/plating,
/area/shuttle/escape)
"kl" = (
/obj/structure/closet/crate/medical,
/obj/item/storage/backpack/duffelbag/med/surgery,
/obj/item/storage/medkit,
/obj/item/healthanalyzer,
/obj/effect/spawner/random/medical/surgery_tool,
/obj/effect/spawner/random/medical/surgery_tool,
/obj/effect/spawner/random/medical/medkit,
/turf/open/floor/plating,
/area/shuttle/escape)
"kG" = (
/obj/effect/spawner/random/entertainment/dice,
/obj/effect/spawner/random/entertainment/gambling,
/obj/effect/spawner/random/entertainment/money_medium,
/obj/structure/closet/crate/large,
/obj/item/dice/d20/fate/cursed/one_use,
/turf/open/floor/plating,
/area/shuttle/escape)
"kH" = (
/obj/effect/spawner/random/entertainment/wallet_storage,
/obj/effect/spawner/random/entertainment/wallet_storage,
/obj/effect/spawner/random/entertainment/wallet_storage,
/obj/effect/spawner/random/entertainment/wallet_storage,
/obj/effect/spawner/random/entertainment/wallet_storage,
/obj/structure/closet/crate/large,
/obj/effect/spawner/random/entertainment/money_small,
/turf/open/floor/plating,
/area/shuttle/escape)
"lg" = (
/obj/effect/turf_decal/box/corners{
	dir = 4
	},
/turf/open/floor/plating,
/area/shuttle/escape)
"lT" = (
/obj/structure/mannequin/wood,
/obj/item/clothing/gloves/maid,
/obj/item/clothing/head/costume/maidheadband,
/obj/item/clothing/neck/maid,
/obj/item/clothing/under/costume/maid,
/obj/structure/closet/crate/large,
/turf/open/floor/catwalk_floor/iron_smooth,
/area/shuttle/escape/engine)
"mG" = (
/obj/structure/filingcabinet/chestdrawer/wheeled,
/obj/item/paperwork/captain,
/obj/item/paperwork/cargo,
/obj/item/paperwork/engineering,
/obj/item/paper_bin/carbon,
/obj/item/pen,
/obj/item/pen/fourcolor,
/obj/structure/closet/crate/large,
/obj/effect/spawner/random/bureaucracy/stamp,
/obj/structure/cable,
/turf/open/floor/catwalk_floor/iron_smooth,
/area/shuttle/escape/engine)
"nE" = (
/obj/machinery/light/small/directional/east,
/turf/open/floor/plating,
/area/shuttle/escape)
"oc" = (
/obj/structure/chair/comfy/shuttle{
	dir = 1;
	name = "Shuttle Captain seat"
	},
/obj/effect/mob_spawn/corpse/human/syndicatepilot/lessenedgear,
/obj/effect/spawner/liquids_spawner{
	reagent_list = list(/datum/reagent/blood = 50)
	},
/obj/effect/decal/cleanable/blood,
/turf/open/floor/mineral/titanium,
/area/shuttle/escape)
"oi" = (
/obj/structure/closet/crate/large,
/obj/structure/reagent_dispensers/fueltank/large,
/turf/open/floor/iron/dark/textured_half{
	dir = 8
	},
/area/shuttle/escape/engine)
"om" = (
/obj/effect/turf_decal/caution/red{
	dir = 4
	},
/turf/open/floor/mineral/titanium/white/airless,
/area/shuttle/escape)
"oG" = (
/obj/effect/turf_decal/box/corners{
	dir = 8
	},
/obj/item/plant_analyzer,
/obj/item/seeds/banana,
/obj/structure/closet/crate/large,
/turf/open/floor/plating,
/area/shuttle/escape)
"oL" = (
/obj/machinery/computer/crew{
	dir = 8
	},
/turf/open/floor/mineral/titanium/white,
/area/shuttle/escape)
"oM" = (
/obj/structure/closet/crate/wooden,
/obj/item/storage/backpack/duffelbag/clown/cream_pie,
/turf/open/floor/plating,
/area/shuttle/escape)
"pD" = (
/obj/effect/turf_decal/box/corners{
	dir = 4
	},
/obj/effect/spawner/random/engineering/tool_advanced,
/obj/effect/spawner/random/engineering/tool,
/obj/effect/spawner/random/engineering/tool,
/obj/structure/closet/crate/large,
/turf/open/floor/plating,
/area/shuttle/escape)
"qf" = (
/obj/structure/closet/crate/large,
/obj/item/stack/spacecash/c100,
/obj/item/stack/spacecash/c10,
/obj/item/stack/spacecash/c10,
/obj/item/stack/spacecash/c50,
/obj/item/stack/spacecash/c20,
/obj/item/stack/spacecash/c20,
/obj/item/stack/spacecash/c200,
/obj/item/stack/spacecash/c10,
/obj/item/clothing/mask/cigarette/rollie/cannabis,
/obj/item/lighter,
/turf/open/floor/plating,
/area/shuttle/escape)
"qi" = (
/obj/machinery/light/directional/south,
/turf/open/floor/catwalk_floor/iron_dark,
/area/shuttle/escape)
"qk" = (
/obj/machinery/computer/emergency_shuttle,
/obj/machinery/light/directional/west,
/turf/open/floor/mineral/titanium/white,
/area/shuttle/escape)
"qq" = (
/turf/open/floor/iron/dark/textured_half,
/area/shuttle/escape/engine)
"qx" = (
/obj/machinery/power/apc/worn_out/directional/south,
/obj/structure/cable,
/turf/open/floor/mineral/titanium/white,
/area/shuttle/escape)
"rE" = (
/turf/template_noop,
/area/template_noop)
"sR" = (
/obj/effect/spawner/random/trash,
/obj/effect/spawner/random/trash,
/obj/effect/spawner/random/trash,
/obj/effect/spawner/random/maintenance/eight,
/obj/structure/closet/crate/large,
/turf/open/floor/plating,
/area/shuttle/escape)
"sT" = (
/turf/closed/wall/mineral/titanium,
/area/shuttle/escape)
"tp" = (
/obj/machinery/computer/aifixer{
	dir = 4
	},
/turf/open/floor/mineral/titanium/white,
/area/shuttle/escape)
"tv" = (
/obj/item/paper/fluff{
	default_raw_text = "<center><font color='blue'><u>Aircraft #6</u></font>'s profit last year was <font color='red'><b>-6240cr</b></font>";
	name = "Recent Air News";
	desc = "Unfortunate. Wonder what that implies for your shuttle.";
	icon_state = "newspaper";
	inhand_icon_state = "newspaper";
	pixel_y = 12
	},
/obj/structure/table/reinforced,
/obj/item/storage/toolbox/guncase/skyrat/pistol/trappiste_small_case/wespe{
	pixel_y = -4
	},
/turf/open/floor/mineral/titanium/white,
/area/shuttle/escape)
"tJ" = (
/obj/effect/decal/cleanable/blood,
/obj/structure/cable,
/turf/open/floor/catwalk_floor/iron_dark,
/area/shuttle/escape)
"uG" = (
/obj/effect/spawner/structure/window/reinforced/shuttle,
/turf/open/floor/plating,
/area/shuttle/escape)
"uI" = (
/obj/effect/turf_decal/caution/stand_clear,
/obj/machinery/door/poddoor/preopen{
	id = "haugan-mail";
	dir = 8;
	name = "cargo bay door"
	},
/obj/structure/cable,
/turf/open/floor/plating/reinforced,
/area/shuttle/escape/engine)
"uL" = (
/obj/item/pickaxe,
/obj/structure/closet/crate/large,
/turf/open/floor/plating,
/area/shuttle/escape)
"vj" = (
/obj/machinery/light/directional/north,
/obj/item/stock_parts/cell/crap,
/obj/item/stock_parts/cell/emergency_light,
/obj/item/stock_parts/cell/lead,
/obj/structure/closet/crate/large,
/obj/item/stock_parts/manipulator,
/turf/open/floor/iron/dark/textured_half,
/area/shuttle/escape/engine)
"vW" = (
/obj/effect/spawner/random/mod/maint,
/obj/effect/spawner/random/mod/maint,
/obj/structure/closet/crate/large,
/turf/open/floor/plating,
/area/shuttle/escape)
"wh" = (
/turf/open/floor/catwalk_floor/iron_smooth,
/area/shuttle/escape/engine)
"xv" = (
/obj/structure/closet/crate/large,
/obj/item/weldingtool/mini,
/turf/open/floor/iron/dark/textured_corner,
/area/shuttle/escape/engine)
"xw" = (
/obj/item/weldingtool,
/obj/item/weldingtool,
/obj/item/multitool,
/obj/item/multitool,
/obj/item/screwdriver,
/obj/item/screwdriver,
/obj/item/wirecutters,
/obj/item/wirecutters,
/obj/structure/closet/crate/large,
/obj/item/wrench,
/obj/item/wrench,
/obj/item/stack/cable_coil,
/obj/item/stack/cable_coil,
/obj/item/crowbar/large/heavy,
/obj/item/crowbar/large/heavy,
/obj/structure/cable,
/turf/open/floor/catwalk_floor/iron_smooth,
/area/shuttle/escape/engine)
"yf" = (
/obj/machinery/button/door/directional/north{
	id = "haugan-mail";
	name = "cargo door controller"
	},
/obj/machinery/light/directional/north,
/turf/open/floor/iron/dark/textured_half,
/area/shuttle/escape/engine)
"zm" = (
/obj/effect/turf_decal/box/corners,
/obj/item/gun/ballistic/automatic/wt550/no_mag,
/obj/item/ammo_box/magazine/wt550m9/starts_empty,
/obj/item/ammo_box/magazine/wt550m9/starts_empty,
/obj/item/ammo_box/magazine/wt550m9/starts_empty,
/obj/item/gun/ballistic/automatic/wt550/no_mag,
/obj/item/gun/ballistic/automatic/wt550/no_mag,
/obj/structure/closet/crate/large,
/turf/open/floor/plating,
/area/shuttle/escape)
"Bs" = (
/obj/machinery/light/directional/south,
/obj/machinery/power/smes/super/full,
/obj/structure/cable,
/turf/open/floor/iron/dark/textured_half,
/area/shuttle/escape/engine)
"BF" = (
/obj/structure/mecha_wreckage/marauder,
/obj/structure/closet/crate/large,
/turf/open/floor/plating,
/area/shuttle/escape)
"BQ" = (
/obj/structure/chair/comfy/shuttle{
	dir = 1;
	name = "Shuttle HoP seat"
	},
/turf/open/floor/mineral/titanium,
/area/shuttle/escape)
"BS" = (
/obj/effect/spawner/random/engineering/flashlight,
/obj/structure/closet/crate,
/turf/open/floor/plating,
/area/shuttle/escape)
"Dh" = (
/obj/item/crowbar/large,
/obj/structure/closet/crate/large,
/turf/open/floor/iron/dark/textured_half{
	dir = 8
	},
/area/shuttle/escape/engine)
"DB" = (
/obj/effect/spawner/random/contraband/narcotics,
/obj/effect/spawner/random/contraband/narcotics,
/obj/effect/spawner/random/contraband/narcotics,
/obj/structure/closet/crate/large,
/turf/open/floor/iron/dark/textured_corner{
	dir = 8
	},
/area/shuttle/escape/engine)
"DI" = (
/obj/machinery/power/terminal{
	dir = 4
	},
/obj/structure/cable,
/turf/open/floor/iron/dark/textured_half,
/area/shuttle/escape/engine)
"DK" = (
/obj/machinery/modular_computer/preset/cargochat{
	name = "ATC chatroom console";
	console_department = "bingbing_airlines";
	dir = 8
	},
/turf/open/floor/mineral/titanium/white,
/area/shuttle/escape)
"DP" = (
/obj/machinery/portable_atmospherics/canister/air,
/obj/structure/closet/crate/large,
/turf/open/floor/plating,
/area/shuttle/escape)
"DY" = (
/turf/open/floor/plating,
/area/shuttle/escape)
"EB" = (
/obj/item/gps/computer/beacon{
	name = "\improper Shuttle GPS beacon";
	gpstag = "7500"
	},
/turf/open/floor/mineral/titanium/white,
/area/shuttle/escape)
"Fa" = (
/obj/structure/closet/crate/mail,
/turf/open/floor/catwalk_floor/iron_smooth,
/area/shuttle/escape/engine)
"Fl" = (
/turf/closed/wall/mineral/plastitanium,
/area/shuttle/escape/engine)
"Gm" = (
/obj/structure/cable,
/turf/open/floor/mineral/titanium/white,
/area/shuttle/escape)
"Gp" = (
/obj/structure/cable,
/turf/open/floor/catwalk_floor/iron_smooth,
/area/shuttle/escape/engine)
"Gx" = (
/obj/structure/cable,
/turf/open/floor/iron/dark/textured_half,
/area/shuttle/escape/engine)
"GN" = (
/obj/machinery/light/small/directional/west,
/turf/open/floor/plating,
/area/shuttle/escape)
"HX" = (
/turf/closed/wall/mineral/plastitanium/nodiagonal,
/area/shuttle/escape/engine)
"IG" = (
/obj/effect/turf_decal/box/corners,
/obj/item/stack/sheet/cardboard/fifty,
/obj/item/cardboard_cutout/nuclear_operative,
/obj/structure/closet/crate/large,
/obj/item/storage/crayons{
	pixel_y = -6
	},
/turf/open/floor/plating,
/area/shuttle/escape)
"IT" = (
/obj/effect/turf_decal/box/corners{
	dir = 8
	},
/obj/effect/spawner/random/structure/crate_abandoned,
/turf/open/floor/plating,
/area/shuttle/escape)
"Jb" = (
/obj/machinery/power/shuttle_engine/propulsion/left,
/turf/open/floor/plating,
/area/shuttle/escape/engine)
"Jf" = (
/turf/open/floor/iron/dark/textured_half{
	dir = 8
	},
/area/shuttle/escape/engine)
"Jo" = (
/obj/structure/closet/l3closet/janitor,
/turf/open/floor/plating,
/area/shuttle/escape)
"Jv" = (
/obj/structure/closet/crate/rcd,
/turf/open/floor/iron/dark/textured_corner{
	dir = 4
	},
/area/shuttle/escape/engine)
"JE" = (
/obj/structure/cable,
/turf/open/floor/catwalk_floor/iron_dark,
/area/shuttle/escape)
"JI" = (
/turf/open/floor/mineral/titanium,
/area/shuttle/escape)
"Ki" = (
/obj/structure/closet/crate/freezer/surplus_limbs,
/turf/open/floor/iron/dark/textured_half,
/area/shuttle/escape/engine)
"Kn" = (
/obj/structure/closet/crate/large,
/obj/item/ai_module/toy_ai,
/obj/item/toy/cards/deck/kotahi,
/obj/item/gun/ballistic/automatic/pistol/toy,
/obj/item/toy/sword,
/turf/open/floor/plating,
/area/shuttle/escape)
"LC" = (
/obj/structure/closet/crate/large,
/obj/machinery/portable_atmospherics/scrubber/huge/movable/cargo,
/obj/item/wrench,
/turf/open/floor/plating,
/area/shuttle/escape)
"Ml" = (
/obj/effect/mapping_helpers/airlock/access/any/supply/general,
/obj/machinery/door/airlock/mining{
	name = "Cargo Hold"
	},
/obj/effect/mapping_helpers/airlock/access/any/security/general,
/turf/open/floor/plating/reinforced,
/area/shuttle/escape/engine)
"MP" = (
/obj/machinery/light/small/directional/west,
/obj/effect/turf_decal/box/corners{
	dir = 1
	},
/turf/open/floor/plating,
/area/shuttle/escape)
"Nn" = (
/obj/structure/closet/crate/large/import,
/obj/item/toy/gun{
	icon_state = "revolversyndie";
	name = "\improper Syndicate Revolver"
	},
/turf/open/floor/iron/dark/textured_corner{
	dir = 1
	},
/area/shuttle/escape/engine)
"NC" = (
/obj/machinery/portable_atmospherics/canister/oxygen,
/obj/structure/closet/crate/large,
/turf/open/floor/plating,
/area/shuttle/escape)
"Of" = (
/obj/effect/turf_decal/box/corners{
	dir = 1
	},
/turf/open/floor/plating,
/area/shuttle/escape)
"Oh" = (
/obj/machinery/door/airlock/command{
	name = "Cockpit"
	},
/obj/effect/mapping_helpers/airlock/access/any/command/general,
/obj/structure/cable,
/turf/open/floor/mineral/titanium/white,
/area/shuttle/escape)
"Op" = (
/turf/open/floor/catwalk_floor/iron_dark,
/area/shuttle/escape)
"Or" = (
/obj/effect/turf_decal/box/corners{
	dir = 8
	},
/turf/open/floor/plating,
/area/shuttle/escape)
"Os" = (
/turf/open/floor/mineral/titanium/white/airless,
/area/shuttle/escape)
"OA" = (
/obj/structure/mineral_door/manual_colony_door{
	name = "spaceplane airlock";
	desc = "<i>\"Pull in case of emergency\"</i> is etched into the front, alternatively, you can open it whilst there is no emergency to create one."
	},
/turf/open/floor/plating,
/area/shuttle/escape)
"OJ" = (
/obj/item/pipe_dispenser,
/obj/item/pipe_painter,
/obj/structure/closet/crate/large,
/turf/open/floor/plating,
/area/shuttle/escape)
"Qw" = (
/obj/machinery/light/small/directional/east,
/obj/effect/turf_decal/box/corners{
	dir = 4
	},
/turf/open/floor/plating,
/area/shuttle/escape)
"Sf" = (
/obj/structure/mineral_door/manual_colony_door{
	name = "spaceplane airlock";
	desc = "<i>'Pull in case of emergency'</i> is etched into the front, alternatively, you can open it whilst there is no emergency to create one."
	},
/turf/open/floor/plating,
/area/shuttle/escape)
"Tb" = (
/obj/machinery/light/directional/north,
/turf/open/floor/plating,
/area/shuttle/escape)
"TO" = (
/obj/item/food/cheese/wheel,
/obj/item/food/cheese/wheel,
/obj/item/food/cheese/wheel,
/obj/item/food/headcheese,
/obj/item/food/cheese/firm_cheese,
/obj/item/food/cheese/mozzarella,
/obj/item/food/crispy_headcheese,
/obj/item/food/sandwich/cheese/grilled,
/obj/structure/closet/crate/large,
/turf/open/floor/plating,
/area/shuttle/escape)
"Up" = (
/obj/effect/turf_decal/box/corners{
	dir = 4
	},
/obj/item/reagent_containers/cup/bottle/potassium{
	pixel_y = -7;
	pixel_x = 7
	},
/obj/item/reagent_containers/cup/bottle/water{
	pixel_y = -7;
	pixel_x = -7
	},
/obj/item/reagent_containers/cup/beaker/large,
/obj/structure/closet/crate/large,
/turf/open/floor/plating,
/area/shuttle/escape)
"UN" = (
/obj/structure/closet/crate/large,
/obj/effect/spawner/random/entertainment/plushie_delux,
/obj/effect/spawner/random/entertainment/plushie_delux,
/obj/effect/spawner/random/entertainment/plushie_delux,
/obj/effect/spawner/random/entertainment/plushie_delux,
/obj/effect/spawner/random/entertainment/plushie_delux,
/obj/effect/spawner/random/entertainment/plushie,
/obj/effect/spawner/random/entertainment/plushie,
/obj/effect/spawner/random/entertainment/plushie,
/obj/effect/spawner/random/entertainment/plushie,
/obj/effect/spawner/random/entertainment/plushie,
/obj/effect/spawner/random/entertainment/plushie,
/obj/effect/spawner/random/entertainment/plushie,
/obj/effect/spawner/random/entertainment/plushie,
/obj/effect/spawner/random/entertainment/plushie,
/obj/effect/spawner/random/entertainment/plushie,
/obj/item/toy/plush/admin/marisa,
/obj/item/toy/plush/lobotomy/bongbong,
/turf/open/floor/iron/dark/textured_half,
/area/shuttle/escape/engine)
"Vh" = (
/obj/structure/closet/crate/mod,
/turf/open/floor/plating,
/area/shuttle/escape)
"VY" = (
/turf/open/floor/mineral/titanium/white,
/area/shuttle/escape)
"Xr" = (
/obj/structure/closet/crate/large,
/obj/effect/turf_decal/box/corners{
	dir = 1
	},
/obj/item/weldingtool/mini,
/turf/open/floor/plating,
/area/shuttle/escape)
"XJ" = (
/obj/structure/chair/comfy/shuttle{
	dir = 8;
	name = "Shuttle RD seat"
	},
/turf/open/floor/mineral/titanium,
/area/shuttle/escape)
"Ym" = (
/obj/structure/closet/crate/large,
/obj/structure/reagent_dispensers/fueltank/large,
/turf/open/floor/plating,
/area/shuttle/escape)
"Zj" = (
/obj/effect/turf_decal/box/corners,
/obj/structure/closet/crate/large,
/obj/item/clothing/suit/space/eva,
/obj/item/clothing/suit/space/eva,
/obj/item/clothing/suit/space/eva,
/obj/item/clothing/head/helmet/space/eva,
/obj/item/clothing/head/helmet/space/eva,
/obj/item/clothing/head/helmet/space/eva,
/obj/item/tank/internals/oxygen/actuallycontainscarbondioxideinstead,
/obj/item/tank/internals/oxygen/actuallycontainscarbondioxideinstead,
/obj/item/tank/internals/oxygen/actuallycontainscarbondioxideinstead,
/obj/item/tank/jetpack/carbondioxide,
/turf/open/floor/plating,
/area/shuttle/escape)
"ZH" = (
/obj/structure/chair/comfy/shuttle{
	dir = 4;
	name = "shuttle CMO seat"
	},
/turf/open/floor/mineral/titanium,
/area/shuttle/escape)

(1,1,1) = {"
rE
rE
rE
rE
rE
rE
rE
rE
rE
rE
rE
rE
rE
rE
rE
rE
rE
rE
rE
rE
rE
rE
rE
rE
rE
Os
rE
rE
rE
rE
"}
(2,1,1) = {"
rE
rE
rE
rE
rE
rE
rE
rE
rE
rE
rE
rE
rE
rE
rE
rE
rE
rE
rE
rE
rE
rE
rE
rE
Os
Os
rE
rE
rE
rE
"}
(3,1,1) = {"
rE
rE
rE
rE
rE
rE
rE
rE
rE
rE
rE
rE
rE
rE
rE
rE
rE
rE
rE
rE
rE
rE
Os
Os
Os
Os
rE
rE
rE
rE
"}
(4,1,1) = {"
rE
rE
rE
rE
rE
rE
rE
rE
rE
rE
rE
rE
rE
rE
rE
rE
rE
rE
rE
rE
Os
Os
Os
Os
Os
Os
rE
rE
rE
rE
"}
(5,1,1) = {"
rE
rE
rE
rE
rE
rE
rE
rE
rE
rE
rE
rE
Os
Os
Os
Os
Os
Os
Os
Os
Os
Os
Os
Os
Os
Os
rE
rE
rE
rE
"}
(6,1,1) = {"
rE
rE
rE
rE
rE
rE
rE
rE
Os
Os
Os
Os
Os
Os
Os
Os
Os
Os
Os
Os
Os
Os
Os
Os
Os
Os
rE
rE
rE
rE
"}
(7,1,1) = {"
rE
rE
uG
uG
uG
sT
uG
sT
uG
sT
uG
sT
uG
sT
uG
sT
uG
sT
uG
sT
uG
sT
HX
Fl
Fl
Fl
Fl
Fl
rE
rE
"}
(8,1,1) = {"
rE
sT
uG
tp
EB
sT
Xr
DY
DY
oG
Op
MP
DY
GN
Jo
Or
Op
Of
BF
GN
aS
Op
Fl
xv
oi
Jf
Jv
Fl
Fl
rE
"}
(9,1,1) = {"
sT
ag
iw
XJ
VY
sT
Ym
DY
DY
BS
Op
DY
kG
DY
DY
kH
Op
OJ
DY
kb
DY
JE
ac
Gx
Gp
mG
gj
aT
Jb
rE
"}
(10,1,1) = {"
uG
qk
oc
JI
VY
sT
lg
DY
qf
ej
Op
Up
DY
aE
DY
IG
Op
hn
oM
DY
as
qi
Fl
yf
lT
Fa
DI
aT
Jb
rE
"}
(11,1,1) = {"
uG
tv
JI
eN
Gm
Oh
tJ
JE
JE
JE
JE
JE
JE
JE
JE
JE
JE
JE
JE
JE
JE
JE
uI
Gx
Gp
xw
Bs
Fl
Fl
Fl
"}
(12,1,1) = {"
uG
dx
BQ
JI
qx
sT
Of
DY
DY
IT
Op
kl
TO
DY
hH
Or
Op
NC
uL
DY
Vh
qi
Fl
vj
wh
at
UN
aT
iy
rE
"}
(13,1,1) = {"
sT
ag
iw
ZH
VY
uG
Tb
DY
vW
DY
Op
DY
DY
sR
DY
DP
Op
DY
DY
Kn
DY
Op
Ml
qq
wh
wh
Ki
aT
iy
rE
"}
(14,1,1) = {"
rE
sT
uG
oL
DK
uG
pD
DY
DY
ej
Op
hc
DY
nE
DY
Zj
Op
Qw
LC
nE
zm
Op
Fl
DB
Jf
Dh
Nn
Fl
Fl
rE
"}
(15,1,1) = {"
rE
rE
uG
uG
uG
sT
uG
sT
uG
sT
Sf
sT
uG
sT
uG
sT
OA
sT
uG
sT
uG
sT
HX
Fl
Fl
Fl
Fl
Fl
rE
rE
"}
(16,1,1) = {"
rE
rE
rE
rE
rE
rE
rE
rE
Os
Os
om
Os
Os
Os
Os
Os
om
Os
Os
Os
Os
Os
Os
Os
Os
Os
rE
rE
rE
rE
"}
(17,1,1) = {"
rE
rE
rE
rE
rE
rE
rE
rE
rE
rE
rE
rE
Os
Os
Os
Os
fj
Os
Os
Os
Os
Os
Os
Os
Os
Os
rE
rE
rE
rE
"}
(18,1,1) = {"
rE
rE
rE
rE
rE
rE
rE
rE
rE
rE
rE
rE
rE
rE
rE
rE
rE
rE
rE
rE
Os
Os
Os
Os
Os
Os
rE
rE
rE
rE
"}
(19,1,1) = {"
rE
rE
rE
rE
rE
rE
rE
rE
rE
rE
rE
rE
rE
rE
rE
rE
rE
rE
rE
rE
rE
rE
Os
Os
Os
Os
rE
rE
rE
rE
"}
(20,1,1) = {"
rE
rE
rE
rE
rE
rE
rE
rE
rE
rE
rE
rE
rE
rE
rE
rE
rE
rE
rE
rE
rE
rE
rE
rE
Os
Os
rE
rE
rE
rE
"}
(21,1,1) = {"
rE
rE
rE
rE
rE
rE
rE
rE
rE
rE
rE
rE
rE
rE
rE
rE
rE
rE
rE
rE
rE
rE
rE
rE
rE
Os
rE
rE
rE
rE
"}
